Date,Card,Type,Description,Credit,Debit,Balance
29 May 2018,8857,Debit,ECRON Management Ltd PUBL01,£0.00,"-£2,385.00","£3,152.39"
18 May 2018,8857,Credit,BANK STHREE PARTNERSHIP0100 F110000203 K,"£2,862.00",£0.00,"£5,537.39"
08 May 2018,8857,Debit,ECRON Management Ltd PUBL01,£0.00,"-£2,650.00","£2,675.39"
08 May 2018,8857,Credit,BANK STHREE PARTNERSHIP0100 F110000105 K,"£3,180.00",£0.00,"£5,325.39"
07 May 2018,8857,Debit,FORX Amazon we 03-05-18 819102765,£0.00,-£0.28,"£2,145.39"
04 May 2018,8857,Debit,"Fin: Amazon web services,44,aws.amazon.c 12.53 USD XR 1.354595",£0.00,-£9.25,"£2,145.67"
04 May 2018,8857,Debit,ECRON Management Ltd PUBL01,£0.00,"-£2,650.00","£2,154.92"
